11244 42112 33321 12444 21123 33211
11222 22112 22221 12222 21122 22211
11111 11111 11111 11111 11111 11111
11111 11111 11111 11111 11111 11111
11222 22112 22221 12222 21122 22211
11233 32112 44421 12333 21124 44211
11233 32112 44421 12333 21124 44211
11222 22112 22221 12222 21122 22211
11111 11111 11111 11111 11111 11111
11111 11111 11111 11111 11111 11111
11222 22112 22221 12222 21122 22211
11244 42112 33321 12444 21123 33211
11244 42112 33321 12444 21123 33211
11222 22112 22221 12222 21122 22211
11111 11111 11111 11111 11111 11111
11111 11111 11111 11111 11111 11111
11222 22112 22221 12222 21122 22211
11233 32112 44421 12333 21124 44211
11233 32112 44421 12333 21124 44211
11222 22112 22221 12222 21122 22211
11111 11111 11111 11111 11111 11111
11111 11111 11111 11111 11111 11111
11222 22112 22221 12222 21122 22211
11244 42112 33321 12444 21123 33211
11244 42112 33321 12444 21123 33211
11222 22112 22221 12222 21122 22211
11111 11111 11111 11111 11111 11111
11111 11111 11111 11111 11111 11111
11222 22112 22221 12222 21122 22211
11233 32112 44421 12333 21124 44211